es to en
el traje = suit
el suéter = sweater
la chaqueta = jacket
la camisa = shirt
la camiseta = t-shirt
la corbata = tie
los zapatos de vestir = dress shoes
los zapatos deportivos = sports shoes
los vanqueros = jeans
el vestido = dress
la falda = skirt
la blusa = blouse
el traje de baño = bathing suit, swimsuit
los pantalones = pants
las sandalias = sandals
las chancletas = flip-flops
los pantalones cortos = shorts
el abrigo = coat
las botas = boots
la bufanda = scarf, muffler
los calcetines = socks
la gorra = cap
los guantes = gloves
la sudadera = sweatshirt
¿Qué estilo de ropa te guesta? = What style of clothes do you like?
Me gusta llevar ropa cóñoda. = I like to wear comfortable clothes.
No me importa el estilo. = I don't care about the style.
la ropa clásica = classic clothes
la ropa elegante = elegant clothes
la ropa informal = casual clothes
