es to en
abatir = to knock down, overthrow, throw down
abato el rey = I overthrow the king
abates el rey = you (informal) overthrow the king
abatís el rey = you (vosotros) overthrow the king
abate el rey = he overthrows the king
abatimos el rey = we overthrow the king
abaten el rey = they overthrow the king
abrasar = burn, set on fire
abraso el rey = I burn the theatre
abrasas el rey = you (informal) burn the theatre
abrasáis el rey = you (vosotros) burn the theatre
abrasa el rey = he burns the theatre
abrasamos el rey = we burn the theatre
abrasan el rey = they burn the theatre
abrazar = to embrace, to hug, to clamp
abrazo la mascota = I hug the pet
abrazas la mascota = you (informal) hug the pet
abrazáis la mascota = you (vosotros) hug the pet
abraza la mascota = he hugs the pet
abrazamos la mascota = we hug the pet
abrazan la mascota = they hug the pet
abrir = to open
abro la ventara = I open the window
abres la ventara = you (informal) open the window
abrís la ventara = you (vosotros) open the window
abre la ventara = he opens the window
abrimos la ventara = we open the window
abren la ventara = they open the window
absolver = to absolve, to acquit
absuelvo el criminal = I absolve the criminal
absuelves el criminal = you (informal) absolve the criminal
absolvéis el criminal = you (vosotros) absolve the criminal
absuelve el criminal = he absolves the criminal
absolvemos el criminal = we absolve the criminal
absuelven el criminal = they absolve the criminal
