es to fr
hago planes = je fais des plans
haces una lista = tu fais une liste
hacemos ejercicio = nous faisons d'exercise
vosotros hacéis la compra = vous faîtes le shopping
hace buen tiempo = il fait beau
caigo enfermo = je tombe malade
caes enfermo = tu tombes malade
la noche cae = la nuit tombe
las manzanas caen del árbol = les pommes tombent de l'arbre
caemos por los escaleras = nous tombons dans les escaliers
digo que tengo hambre = je dis que j'ai du faim
dices que tienes hambre = tu dis que tu as du faim
dicen que tienen hambre = ils disent qu'ils ont du faim
decimos que tenemos hambre = nous disons que nous avons du faim
decís que tenéis hambre = vous dîtes que vous avez du faim
oigo música = j'écoute de la musique
oyes hablar de francés = tu entends parler du français
oye decir que el cielo es azul = il entend dire que le ciel est bleu 
oímos mal = nous entendons mal
oís música = nous écoutons de la musique
pongo fin a algo = je mets fin à quelque chose
poner fin a algo = mettre fin à quelque chose
salgo al cine = je sors au cinéma 
saler a comer = sortir manger
sale para una lugar = il part pour un endroit
tengo la respuesta = j'ai la réponse
tienes la pregunta = tu as la question
tiene miedo = tu as peur
tenemos raz = nous avons raision
tienen algunas suerte = ils ont de la chance
tenéis cinco años = vous avez cinq ans
