es to en
el abuelo, la abuela = the grandfather, the grandmother
el mejor amigo, la mejor amiga = the best friend (m, f)
el amor = (the) love
la bebida = the drink
las cartas = playing cards
la casa = the house
la celebración = the celebration
la cena = supper, dinner
el chiste = the joke
la comedia = the food
el cuento = the story
el deseo = the wish
la familia = the family
la flor = the flower
el globo = the balloon
el hermano, la hermana = the brother, the sister
el invitado, la invitada = the guest (m, f)
la mamá = the mom
el papá = the dad
la merienda = the snack
el novio, la novia = the boyfriend, the girlfriend
el ojo = the eye
el pelo = hair
el primo, la prima = the cousin (m, f)
el pariente = the relative
el pastel = the cake
el regalo = the gift
el tío, la tía = the uncle, the ant
la vela = the candle
el videojuego = the video game
el voleibol = the volleyball
