fr to en
le cercle = the circle
l'isolement, un isolement = the isolation, an isolation
le service = the favor
exiger = to demand, require, expect
gêner = to bother, embarrass
passer son temps à faire quelque chose = pass the time doing something
préciser = to specify, to define
se comporter = to behave
se faire des amis = to make friends
je me sens que tu me caches quelque chose = I feel you are hiding something from me
s'entraider = to help one another
nous nous entraidons = we help one another
se plaindre = to complain
se sentir malade = to feel sick
suffoqué, soffoquée = suffocated
soigner = to take care of
sympathiser = to click, feel compatible
chaleureux, chaleureuse = warm, friendly
coincé, coince = durable
exigeant, exigeante = demanding
franchement = frankly
froid, froide = cold
indifférent, indifférente = indifferent
insensible = insensitive
sensible = sensitive
ouvert, ouverte = open
profond, profonde = deep
réservé, réservée = reserved
sincèrement = honsestly
suffocant, suffocante = stifling